Date,Description,Debit,Credit,Balance
2020-04-03,TRF/095/,41290.0,,897542.26
2020-04-11,GST @18% on Charge,9.0,,897533.26
2020-04-11,Consolidated Charges for A/c,50.0,,897483.26
2020-04-13,By Clg 118722 002  Delhi,,116080.0,1013563.26
2020-04-20,TRF TO SALARY,22710.0,,990853.26
2020-05-16,GST @18% on Charge,9.0,,990844.26
2020-05-16,Consolidated Charges for A/c,50.0,,990794.26
2020-05-20,By Clg 182113 259  Delhi,,175080.0,1165874.26
